*X***X*******X*****X
*X*XXX*XXX*X*XXXXX*X
*X***X*X***X*X*****X
*X*X*X*X*XXX*X*XXX*X
*X*X***X***X*X***X*X
*X*XXXXXXX*X*XXX*XXX
*X*X*******X***X***X
*X*X*XXXXXXXXX*XXX*X
*X*X*X*******X***X*X
*XXX*X*XXXXXXXXX*X*X
*****X*X*******X*X*X
XXXXXX*X*XXXXX*X*X*X
*X***X***X***X*X*X*X
*X*X*X*XXXXX*X*X*X*X
***X***X*****X***X*X
*XXXXXXX*XXX*XXXXX*X
*X***X***X*X*X*****X
*X*X*X*XXX*X*XXXXX*X
***X***X***********X
XXXXXXXXXXXXXXXXXX**
